00000000000000000000000000999999
00000000000000000000000000999999
00000000000000000000000200999999
S1112A20000002E23333332D00999999
00000200000000200000000200999999
00000300000000300000000300099999
00000300000000300000000300009999
00000300000000300000000300000999
00000300000000300000000300000099
00000300000000300000000300000009
00000300000000300000000300000000
00000200000000300000000200000000
00000B23333333333333332C20000000
00000200000000300000000000000000
00000000000000300000000000000000
00000000000000300000000000000000
99000000000000300000000000000000
99990000000000300000000000000000
99999900000000200000000000000000
99999999000000F233333333332G2000
99999999999900200000000000020000
99999999999900000000000000010000
99999999999999000000000000010000
999999999999999900000000000H0000