00000000000000000000000000000000
00000000000000000000000002000000
S1112A200000002E233333332D000000
00000200000000020000000002000000
00000300000000030000000003000000
00000300000000030000000003000000
00000300000000030000000003000000
00000300000000030000000003000000
00000300000000030000000003000000
00000300000000030000000003000000
00000300000000030000000003000000
00000200000000030000000002000000
00000B2333333333333333332C200000
00000200000000030000000000000000
00000000000000030000000000000000
00000000000000030000000000000000
00000000000000030000000000000000
00000000000000030000000000000000
00000000000000030000000000000000
00000000000000030000000000000000
00000000000000020000000000000000
000000000000000F233333332G200000
00000000000000020000000002000000
00000000000000000000000000H00000